
MMMMMMMMMMMMMMMMMMMMMMMMMMMMMMMMMMMMMMMMMMMMMMMMMMMMMMMMMMMMMMMMMMMMMMMMMMMMMMMMMMMMMMMMMMMMMMMMMMMM    
M55555555555555555555555555555-D55555555R-5555555555555555555555555555R5R55555555555555-555555555R5M
M5555555555555555555555555555-555555555555555555555555555555555555555555R5D5555555R-555555555555555M
M555555	R-555555-R555555555555-5555555555555555555555555555R55555R55555555R55555555555555R555555555M 											   											   M											   M
M555555555555555555555555555555555555555555555555555555555555555R5555555R55555555555555R55555555555M
M5R5555555555555555555555555555555555555555555555555555555555555555555555555555555R555555R555555R55M
M5R555555555-5-5555555555555555555555555R555555555555555555555555555555555555555555555555R555R5R555M
M5555555555555555R5R555555555555555555555RR555RR555555555555555555555555555555555R5555555R55555R555M
M5555555555555R555555555R55555555555555555R5555555555555555555555R5555555-5R5555555555555R55555R555M
MMMMMMMMMMMMMMMMMMMMMMMMMMMMMMMMMMMMMMMMMMMMMMMMMMMMMMMMMMMMMMMMMMMMMMMMMMMMMMMMMMMM555555555555555M	 								   
M555555555555555555555555555555555555555555D55555555555R55555555R55555555555D555555555555R555555555M
M55555555555555555555555R55555555555555555R555555555555555555555555555555R5555R5555D555555555555555M
M555D555555555555555555555R5555555R55555555555555555555555555555555555555RR555R555555R5555555555555M       
M555R55555555555555555555555555555555555R5555555555555555555555555555555555555R5555R555555555555555M
M55R555555555555555555555555555555555555R5555555555555555555555RR5555555555555555555555555555555555M
M5R55555555555555555555555555555555555555555555555555555555555R55R555555D5555555555555R5555D5555R55M
M5DR555555555555555555555555555555555555555555555555555555555555RRR55555R5555555555555D5555555555R5M
M55555555555555555555555555MMMMMMMMMMMMMMMMMMMMMMMMMMMMMMMMMMMMMMMMMMMMMMMMMMMMMMMMMMMMMMMMMMMMMMMMM   										       
M55555555555555555555555555555-555555D55555555555R55555555555555555R5555555555555555555555555555555M
M5--55555555555555555555555555555555555555RR55555R55555555555555555555555555R555555555555555555555PM
M5RR555555555555555555555R55555555555555555555R5555555555--5555555555555555555555555555555555555555M   
M55R55555R55555555555555555555555555555555555555555555555555555555555555555555555555555555555555555M
M555555555RD5555555555555555555555555555555555R5555555555555555555555555555555555555555555555555555M 
M5555555-55555555555555555-5555-5555555555555555555555555555555555555555555555555555555555555555555M
M55555555555555RD55555555555R55555555R555555RR555555555555555555555R5555RD5555555555555555555555555M
M55555555555555R55555-555555555555555555555555555555555555555555R5555RD5555555555555555555555555555M
M55D55555555555555555R5555555555-5555555555555555555555555555-55R55555R5555555555555555555555555555M 
MMMMMMMMMMMMMMMMMMMMMMMMMMMMMMMMMMMMMMMMMMMMMMMMMMMMMMMMMMMMMMMMMMMMMMMMMMMMMMMMMMMMMMMMMMMMMMMMMMMM 											         

